NO ./tester_parsing_cub3d/assets/pissaladiere.xpm
SO ./tester_parsing_cub3d/assets/pissaladiere.xpm
EA ./tester_parsing_cub3d/assets/pissaladiere.xpm
WE ./tester_parsing_cub3d/assets/pissaladiere.xpm

F 101,67,33

C 135,206,235

1111
1  1
1N 1
1111
