NO ./textures/minecraft/north.xpm
SO ./textures/minecraft/south.xpm
WE ./textures/minecraft/west.xpm
EA ./textures/minecraft/east.xpm

F 230,30,0
C 0,30,255

111111111111111111111111111111111111111111111111111111111111
100000000000000000000000000000000000000000000000000000000001
100011111111111111110000000000000000000000111011100000000001
100000000000000000000000000000000000000000100000100000000001
100000000000000000000000000000000000000000100000100000000001
100000000000000000000000000000000000000000100000100000000001
100000000000000000000000000000000000000000100000100000000001
10000000011111111111111111111000000000000100N001000000000001
100000000000000000000000000000000000000000100000100000000011
100000000000000000000000000000000000000000111111100000000001
100000000000000000000000000000000000000000000000000000000001
100000000000000000000000000000000000000000100000000000000001
100000000000000011111100000000000000000000100000000000000001
100000000000000000000100000000000000000000100000000000000001
111111111111111111111111111111111111111111111111111111111111