NO ./textures/wolfenstein/red_brick.xpm
SO ./textures/wolfenstein/wood.xpm
WE ./textures/wolfenstein/color_stone.xpm
EA ./textures/wolfenstein/eagle.xpm

C 135,206,235
F 101,100,33


111111111111111111111111111111
100000000000000020000000000001
100000000000000010000000000001
100000000000000110000000000001
100E00000000000110000000000001
100000000000000020000000000001111111111111111
100000000000000010000000000000100000000000001
100000000000000020000000000000200000000000001
111111111111111111111111111111111111111100001
                                       100001
                                       100001
                                       100001
                                       100001
                                       1000011111111111111111111
                                       1000000000000000000000001
                                       1111111111111111111111111
