NO ./textures/wolfenstein/purple_stone.xpm
SO ./textures/wolfenstein/blue_stone.xpm
WE ./textures/wolfenstein/color_stone.xpm
EA ./textures/wolfenstein/grey_stone.xpm

C 135,206,235
F 101,100,33


111111111111111111111111111111
100000000000000000000000000001
100000000000000000000000000001        1111111111111111111111
100000000000000110000000000001        1000000000000000000001
100E00000000000110000000000001        1010000000000000000001
100000000000000000000000000001111111111011111000000000001111
100000000000000000000000000000000000000000001000000010111111
100000000000000000000000000000000000000000001000000000000111
11111111111111111111111111111111111111110000111000000010001111
                                       10000110000011110000001
                                       10000111111111111011101
                                       10000111111111100000001
                                       10000111111111111110111
                                       1000011111111111111011111
                                       1000000000000000000000001
                                       1111111111111111111111111
