NO ./textures/minecraft/north.xpm
SO ./textures/minecraft/south.xpm
WE ./textures/minecraft/west.xpm
EA ./textures/minecraft/east.xpm
C 10, 10, 110
F 67, 99, 10

111111111111111
100000000000001
100000000000001
100000000000001
100000000000001 N
100000000000001
100000000000001
100000000000001
111111111111111