NO ./textures/minecraft/north.xpm
SO ./textures/minecraft/south.xpm
WE ./textures/minecraft/west.xpm
EA ./textures/minecraft/east.xpm
C 10, 10, 10
F 10, 10, 10

1111111111111111111111111
1000000000000000000000001
1000000000000000000000001
1000000000000000000000001
1000000111111111110000001
10000001         10000001
10000001         10000001
10000001         10000001
10000001         10000001
10000001         10000001
10000001         10000001
100000011111N111110000001
1000000000000000000000001
1000000000000000000000001
1000000000000000000000001
1111111111111111111111111