NO ./textures/minecraft/north.xpm
SO ./textures/minecraft/south.xpm
WE ./textures/minecraft/west.xpm
EA ./textures/minecraft/east.xpm
C 10, 110, 10
F 40, 20, 10

1111111111111111111111111
1000000000000000000000001
1000000000000000000000001
1000000000000000000000001
1000000111111111110000001
10000001         10000001
10000001         10000001
10000001         10000001
10000001         10000001
10000001         10000001
10000001         10000001
1000000111111111110000001
1000000000000000000000001
100000000000N000000000001
1000000000000000000000001
1111111111111111111111111